5 5 
3 1 1 1 2 
2 0 0 0 3 
3 1 0 1 2 
0 1 0 1 0 
0 0 0 0 0 